NO ./test.xpm
SO ./test.xpm
WE ./test.xpm


EA ./test.xpm
F 220,100,0

C 225,30,0


11111111
10000001
10011000
10011001
1000000111
11111111


