NO ./test.xpm
SO ./test.xpm
WE ./test.xpm


EA ./test.xpm
F 220,100,0

C 225,30,0


 11
1011111111
1N11111111111
111111111111