NO ./test.xpm
SO ./test.xpm
WE ./test.xpm


EA ./test.xpm
F 220,100,0

C 225,30,0


11111111
10000001
10011001
1N011001
1000000111
1000110011
111111111


11111111111111111
